11111111111111111111111011111111111111111111111
10000010000000001010101000001000100000000000001
10111110111111101010101011101010101111101111101
10100000000000101000001000101010101000100010101
10101111111110101111101010101011101010111110101
10101000000000100000001010100000001010000000101
10101111111111111111111011111111111011111111101
10101000000000000010001000000000001010000000001
10101111111111111010111011111111101010101111111
10101000100010001000000010000000101010101000001
10101010101010101110111110111110101010101011101
10101010001000100010000000100010101010101010001
10101110111111111011111111111010101010101010111
10001000101000001000000010000010101010101010001
10111010101011111111111010101011101011101011101
10000010001000000000001010101000101000101010001
11111111111111111111101010101110101010101010111
10000000000000000000101010100010101010101010101
10111111101111111010101010101110101010101010101
10100000000000001010101000101000101010101010101
10101111111111101011101111101011101110101010101
10101000000000101010000000001000000000101010001
10101011111110101010111111111111111110101111101
10101000100010101010100000000000000010101000001
10111110101010101010111111111110111011101011111
10001000101010101010000010000010001000101000101
11101011101110101010111010111111101110101110101
10101000100010101010101010000000100010100000101
10101110111010101010101011111110111011111111101
10100000001010101010001010000010001000000010001
10111111111010101011111010101011101111111010101
10000000001010101000000010101000001000101010101
10111111101010101111111110101111111010101010101
10100000101010101000001010101000000010001010101
10101110101010101011101010101011111111111010101
10101000101010101000101010100010000000000010101
10101011101010111111101010111110111111111110101
10101010100000100000001000100000001000001000101
10101010111111111111101010101111101011101111101
10101010001000000000001010101000001000101000001
10101011101011111111111110101111101110101011101
10101000001000000000100000101000000000101010001
10101111111111111110101111101111111111101010111
10000000000000100010101000000000000000101010001
10111111101110101110101111111111111111101111101
10100000000010000000000000000000000000000000001
10111111111111111111111111111111111111111111111